111111111111111111111111111111
100000000000000000000001110001
100000011111111100000000000001
100000000000000000111110000001
100000000000000000000000000001
100000001111111111110000000001
100000001000000000010000000001
100000001000000000010000000001
100000000000000000010000000001
100000000000000000010000000001
100000000000000000000020000001
100000001111111111111111000001
100000000000000000000000000001
100000000000000000000000000001
100000022222222222222222000001
100000000000000000000000000001
100000011111111111111111000001
100000000000000000000000000001
111111111111111111111111111111